52222222222222222222222222222222222222222222222226
1                                                7
1                                                e
1      v                                         
1   s                                        52226
1  52222226                         v            3
1                                                3
1                                5222226         3
1                                                3
1  52222226         v             v           5223
1                          s                     3
1                  52222222222222226             3
1                                                3
1  52222226                             5222222223
1                                                3
1                5222226                         3  
1                                                3
1  h                 v                           3
1                                  s             3
84444444444444444444444444444444444444444444444447